25 20
##D######################
#.@...h............s....#
#######################.#
                      #.#
#######################.#
#.g...........s.........#
#........s..............#
#..######################
#..#
#h.##############
#............g...#
#.................#
#..Kg...........g..##
#....................#
#...g.................##
#..............g........#
#....................g..#
#.......................#
#.h.................h..#
###################D###