25 20
##D######################
#.@...h......C.....s....#
#######################.#
                      #.#
#######################.#
#.g...........s.........#
#........s........C.....#
#..######################
#..#
#h.##############
#............g...#
#.................#
#..Kg...........g..##
#..........C.........#
#...g......CC.........##
#..............g........#
#....................g..#
#.......................#
#.h.................h..#
###################D###