25 20
##D######################
#.@...h............s....#
#######################.#
                      #.#
#######################.#
#.............s.........#
#........s..............#
#..######################
#..#
#h.##############
#................#
#.................#
#..Kg..............##
#....................#
#.....................##
#..............g........#
#.......................#
#.......................#
#.h.................h..#
###################D###