25 20
##.######################
#.@................s....#
#######################.#
                      #.#
#######################.#
#.............s.........#
#........s..............#
#..######################
#..#
#..##############
#................#
#.................#
#..Ks..............##
#....................#
#.....................##
#..............s........#
#.......................#
#.......................#
#......................#
###################D###