25 20
      ##############
      #......@.....#
      #............#
      #.....g.g....#
      #......K.....#
      #............#
      ######...#####
           #...#
#############D###########
#.......................#
#.......................#
#.......................#
#.......................#
#............b..........#
#.......................#
#.......................#
#.......................#
#.......................#
#.......................#
#########################