25 20
      ##############
      #.h....@...h.#
      #............#
      #.....g.g....#
      #......K.....#
      #.h..........#
      ######...#####
           #...#
#############D###########
#.h...................h.#
#.......................#
#.......................#
#.......................#
#............b..........#
#.......................#
#.......................#
#.......................#
#.......................#
#.h...................h.#
#########################