25 20
      ##############
      #......@.....#
      #............#
      #.....s.s....#
      #......K.....#
      #............#
      ######...#####
           #...#
#############D###########
#.......................#
#.......................#
#.......................#
#.......................#
#............s..........#
#.......................#
#.......................#
#.......................#
#.......................#
#.......................#
#########################